1111111111111
1C010C00000C1
1000011111001
1C0011EP00001
1111111111111