11111111111111111111
1P0000000000000000C1
10001111111000110001
10101000001010000101
10100111100010101001
10101000101010010101
10001111001110000101
1E000000000000000001
11111111111111111111