11111111111111111111111111111111111111
10000000000000000000000000000000000001
10111111011111111111111111111111111111
10100001000000000000010111111111111111
100000P0000000000000010110000001111101
10111111011111111111110110000001100101
10100000000000000000010111111111100101
10111111010111111111110110000000100101
1C10000000000000000000E111111111100101
10111111010111111111111111111111111111
10100001000000000001100111000000000001
10100001000000000001100111000000000001
10111111011111111111111111111111111111
10100000000000000001000111111111111111
10111111011111111111111111100000000001
10100000000000000101111111100000000001
10100000000000000100001111111110011111
10111111011111111101001110000000000001
10100000000000000001000000000000000001
11111111111111111111111111111111111111