11111111111111111111111111111111111111
1P111111111111111111111111111111111C11
10111000000000000000000000000000000001
10001000111111111000000111111100010101
10101000000000000000000000000000000001
10101111111111111111111111111111100001
10100000000000000000000000000000000001
10101111111111111111111111111111100001
10100000000000000000000000000000000001
10101111111111111111111111111111100001
10100000000000000000000000000000000001
10101111111111111111111111111111100001
10100000000000000000000000000000000001
10101000000000000000000000000000000001
10001011111111100000011111111100010101
10110000000000000000000000000000000001
10000000000000000000000000000000000001
10001111111111111111111111111111111111
1E000000000000000000000000000000000001
11111111111111111111111111111111111111